3,3,3,3,3
0,0,0,0,0
0,0,0,0,0
-2302,0,0,0,1404
0,0,0,0,0
0,0,0,0,0
4,4,4,4,4
