0,0,2,2,2,2,2,0,0,9
0,0,0,0,0,0,0,0,0,0
0,0,2,2,2,2,2,0,0,0
0,0,2,2,2,2,2,0,5,0
0,0,0,0,0,0,0,0,0,0
0,0,2,2,2,2,2,0,0,0
0,0,2,2,2,2,2,0,4,4
210,0,0,0,0,0,0,0,4,4
