0,0,2,2,2,2,2,0,0,9
0,0,0,0,0,0,0,0,0,0
0,0,2,2,2,2,2,0,0,0
0,0,2,2,2,2,2,0,5,0
0,0,0,0,0,0,0,0,0,0
0,0,2,2,2,2,2,0,0,0
0,0,2,2,2,2,2,0,0,0
410,0,0,0,0,0,0,0,0,420
