1,1,0,0,0,0,0,0,0,390
1,1,2,2,2,2,2,0,0,0
0,0,0,0,0,0,0,0,0,0
0,0,2,2,2,2,2,0,5,0
0,0,2,2,2,2,2,0,0,0
0,0,0,0,0,0,0,0,0,0
0,0,2,2,2,2,2,0,0,0
0,0,2,2,2,2,2,0,0,9
