3,3,3,0,1,0,3,3,3
0,0,0,0,0,0,0,0,0
0,0,5,5,0,5,5,0,0
2301,0,0,0,0,0,0,0,2402
0,0,5,5,0,5,5,0,0
0,0,0,0,0,0,0,0,0
4,4,4,0,98,0,4,4,4
