-3,-3,-3,0,2,0,-3,-3,-3
0,0,0,0,0,0,0,0,0
0,0,0,0,0,0,0,0,0
801,0,0,0,7,0,0,0,-901
0,0,0,0,0,0,0,0,0
0,0,0,0,0,0,0,0,0
3,3,3,0,-2,0,3,3,3
