3,3,3,0,1,0,3,3,3
0,0,0,0,0,0,0,0,0
0,0,0,0,0,0,0,0,0
0,0,0,0,0,0,0,0,902
0,0,0,0,0,0,0,0,0
0,0,0,0,0,0,0,0,0
-3,-3,-3,0,98,0,-3,-3,-3
