8,8,5,8,8
0,0,0,0,0
0,0,0,0,0
3099,0,0,0,492
0,0,0,0,0
0,0,0,0,0
4,4,5,4,4
