3,3,3,3,3
0,0,0,0,0
0,0,0,0,0
-2399,0,0,0,-1403
0,0,0,0,0
0,0,0,0,0
4,4,4,4,4
